20 20
********************
*&   #          O  *
*    ****  ****----*
*    *      *      *
*    *   #### *    *
*    *         *   *
*   ********* *    *
*   *         *    *
*   *  X      *    *
*   ********* *    *
*             *    *
*    ******   *X   *
*   X          *   *
*    ########  *   *
*              *   *
*  ********    *   *
*      #       *   *
*  X        @  * D *
*              *   *
********************
