10 10
**********
*&       *
*  ****  *
* *    * *
* *  **  *
*   @**  *
*  **    *
*   *    *
*       D*
**********