10 10
**********
*P   @  D*
*  ****  *
*  *  *  *
*&   **  *
*  **    *
*  ****  *
*        *
*        *
**********